1111111111111111111111111111
1000100000000000000000000001
1000111000000000000010001111
1P0000000C0000000000111111E1
100000000C000000000000000001
1000000000000000000000000001
1000100000000000000000000001
1000111000000000000010001111
1000000000000000000011111111
1000000000000000000000000001
1000000000000000000000000001
1111111111111111111111111111
