1111111111111111111111111111
1000100000C0000000C000000001
1000111000100000000010001111
1P000000001000011000111111E1
100000000010001010000C000001
100000000000000C100000000001
1000100000000001000000000001
10001110010000000C0010001111
1000000100000000000011111111
1000000100000000C00000000001
1000001000000000000000000001
1111111111111111111111111111
