1111111111111111111111111111
100010C000000000000000000001
1000111000000000000010C01111
1P000000000000000000111111E1
100000000000C000000000000001
10000000C0000000000000000001
100010C000000000000000000001
1000111000000000000010C01111
1000000000000000000011111111
100000000000C000000000000001
10000000C0000000000000000001
1111111111111111111111111111
